13,3,9,5,5,5,5,3,9,3
9,6,10,13,1,7,9,6,10,10
12,5,4,1,0,3,8,3,10,14
9,1,5,6,10,10,14,12,6,11
14,14,9,3,10,12,7,13,1,2
9,3,10,12,6,9,5,5,2,10
10,10,8,3,13,4,3,11,10,14
10,12,6,12,7,9,6,10,12,3
8,5,5,5,5,2,11,12,3,10
12,5,5,5,5,4,4,5,6,14